{
    "a":         ["0x00", "0x04"],
    "b":         ["0x00", "0x05"],
    "c":         ["0x00", "0x06"],
    "d":         ["0x00", "0x07"],
    "e":         ["0x00", "0x08"],
    "f":         ["0x00", "0x09"],
    "g":         ["0x00", "0x0A"],
    "h":         ["0x00", "0x0B"],
    "i":         ["0x00", "0x0C"],
    "j":         ["0x00", "0x0D"],
    "k":         ["0x00", "0x0E"],
    "l":         ["0x00", "0x0F"],
    "m":         ["0x00", "0x10"],
    "n":         ["0x00", "0x11"],
    "o":         ["0x00", "0x12"],
    "p":         ["0x00", "0x13"],
    "q":         ["0x00", "0x14"],
    "r":         ["0x00", "0x15"],
    "s":         ["0x00", "0x16"],
    "t":         ["0x00", "0x17"],
    "u":         ["0x00", "0x18"],
    "v":         ["0x00", "0x19"],
    "w":         ["0x00", "0x1A"],
    "x":         ["0x00", "0x1B"],
    "y":         ["0x00", "0x1C"],
    "z":         ["0x00", "0x1D"],
    "A":         ["0x02", "0x04"],
    "B":         ["0x02", "0x05"],
    "C":         ["0x02", "0x06"],
    "D":         ["0x02", "0x07"],
    "E":         ["0x02", "0x08"],
    "F":         ["0x02", "0x09"],
    "G":         ["0x02", "0x0A"],
    "H":         ["0x02", "0x0B"],
    "I":         ["0x02", "0x0C"],
    "J":         ["0x02", "0x0D"],
    "K":         ["0x02", "0x0E"],
    "L":         ["0x02", "0x0F"],
    "M":         ["0x02", "0x10"],
    "N":         ["0x02", "0x11"],
    "O":         ["0x02", "0x12"],
    "P":         ["0x02", "0x13"],
    "Q":         ["0x02", "0x14"],
    "R":         ["0x02", "0x15"],
    "S":         ["0x02", "0x16"],
    "T":         ["0x02", "0x17"],
    "U":         ["0x02", "0x18"],
    "V":         ["0x02", "0x19"],
    "W":         ["0x02", "0x1A"],
    "X":         ["0x02", "0x1B"],
    "Y":         ["0x02", "0x1C"],
    "Z":         ["0x02", "0x1D"],
    "1":         ["0x00", "0x1E"],
    "2":         ["0x00", "0x1F"],
    "3":         ["0x00", "0x20"],
    "4":         ["0x00", "0x21"],
    "5":         ["0x00", "0x22"],
    "6":         ["0x00", "0x23"],
    "7":         ["0x00", "0x24"],
    "8":         ["0x00", "0x25"],
    "9":         ["0x00", "0x26"],
    "0":         ["0x00", "0x27"],
    "!":         ["0x02", "0x1E"],
    "@":         ["0x02", "0x1F"],
    "#":         ["0x02", "0x20"],
    "$":         ["0x02", "0x21"],
    "%":         ["0x02", "0x22"],
    "^":         ["0x02", "0x23"],
    "&":         ["0x02", "0x24"],
    "*":         ["0x02", "0x25"],
    "(":         ["0x02", "0x26"],
    ")":         ["0x02", "0x27"],
    " ":         ["0x00", "0x2C"],
    "-":         ["0x00", "0x2D"],
    "=":         ["0x00", "0x2E"],
    "[":         ["0x00", "0x2F"],
    "]":         ["0x00", "0x30"],
    "\\":        ["0x00", "0x31"],
    ";":         ["0x00", "0x33"],
    "'":         ["0x00", "0x34"],
    "`":         ["0x00", "0x35"],
    ",":         ["0x00", "0x36"],
    ".":         ["0x00", "0x37"],
    "/":         ["0x00", "0x38"],
    "_":         ["0x02", "0x2D"],
    "+":         ["0x02", "0x2E"],
    "{":         ["0x02", "0x2F"],
    "}":         ["0x02", "0x30"],
    "|":         ["0x02", "0x31"],
    ":":         ["0x02", "0x33"],
    "\"":        ["0x02", "0x34"],
    "~":         ["0x02", "0x35"],
    "<":         ["0x02", "0x36"],
    ">":         ["0x02", "0x37"],
    "?":         ["0x02", "0x38"],
    "\n":        ["0x00", "0x28"],
    "CTRL":      ["0x01", "0x00"],
    "SHIFT":     ["0x02", "0x00"],
    "ALT":       ["0x04", "0x00"],
    "WIN":       ["0x08", "0x00"],
    "CMD":       ["0x08", "0x00"],
    "GUI":       ["0x08", "0x00"],
    "ENTER":     ["0x00", "0x28"],
    "ESC":       ["0x00", "0x29"],
    "BACKSPACE": ["0x00", "0x2a"],
    "TAB":       ["0x00", "0x2b"],
    "SPACE":     ["0x00", "0x2c"],
    "CAPS_LOCK": ["0x00", "0x39"],
    "F1":        ["0x00", "0x3a"],
    "F2":        ["0x00", "0x3b"],
    "F3":        ["0x00", "0x3c"],
    "F4":        ["0x00", "0x3d"],
    "F5":        ["0x00", "0x3e"],
    "F6":        ["0x00", "0x3f"],
    "F7":        ["0x00", "0x40"],
    "F8":        ["0x00", "0x41"],
    "F9":        ["0x00", "0x42"],
    "F10":       ["0x00", "0x43"],
    "F11":       ["0x00", "0x44"],
    "F12":       ["0x00", "0x45"],
    "PRT_SCR":   ["0x00", "0x46"],
    "SCR_LOCK":  ["0x00", "0x47"],
    "PAUSE":     ["0x00", "0x48"],
    "BREAK":     ["0x00", "0x48"],
    "INSERT":    ["0x00", "0x49"],
    "HOME":      ["0x00", "0x4a"],
    "PAGE_UP":   ["0x00", "0x4b"],
    "DEL":       ["0x00", "0x4c"],
    "END":       ["0x00", "0x4d"],
    "PAGE_DOWN": ["0x00", "0x4e"],
    "RIGHT":     ["0x00", "0x4f"],
    "LEFT":      ["0x00", "0x50"],
    "DOWN":      ["0x00", "0x51"],
    "UP":        ["0x00", "0x52"],
    "NUM_LOCK":  ["0x00", "0x53"]
 }
 